20 15
47 47 47 47 47 26 -1 -1 121 57 57 57 57 57 57 57 57 57 57 120 
80 -1 -1 -1 -1 80 -1 -1 -1 59 -1 -1 -1 59 -1 -1 -1 133 -1 59 
80 -1 82 -1 -1 80 -1 -1 -1 59 122 117 -1 59 -1 13 -1 91 -1 59 
80 -1 -1 -1 -1 80 -1 -1 -1 59 -1 138 -1 59 -1 34 -1 91 -1 59 
47 47 26 75 68 26 -1 -1 -1 59 63 63 63 59 63 63 85 91 -1 59 
80 -1 -1 135 -1 -1 -1 -1 -1 -1 -1 -1 -1 -1 -1 59 -1 91 -1 59 
80 -1 -1 135 -1 -1 -1 -1 -1 -1 -1 -1 -1 -1 -1 59 -1 91 -1 59 
80 -1 -1 135 -1 -1 -1 -1 -1 -1 -1 -1 -1 -1 -1 50 -1 91 102 59 
47 47 47 47 47 132 -1 -1 -1 -1 -1 -1 -1 -1 127 63 63 63 63 59 
-1 -1 -1 -1 -1 -1 -1 -1 -1 -1 -1 -1 -1 -1 -1 -1 -1 113 -1 -1 
-1 -1 -1 -1 -1 -1 -1 -1 -1 53 32 11 -1 -1 -1 -1 -1 113 130 -1 
-1 -1 -1 -1 -1 -1 -1 -1 -1 -1 -1 -1 -1 -1 -1 -1 24 65 65 65 
-1 -1 88 -1 -1 -1 -1 -1 -1 -1 -1 -1 -1 -1 -1 24 3 19 19 19 
31 31 31 31 31 31 31 10 -1 -1 -1 -1 -1 86 65 3 19 19 19 19 
33 33 33 33 33 33 33 33 134 134 134 134 134 134 134 19 19 19 19 19 
